11 8
@.........@
@+@.x@x.@;@
@+@.@@x.@;@
@+@.x@x.@;@
@+..@@x..;@
@+@.x@x.@;@
@+@.@@x.@;@
@+...O...;@